11111111111111
10010000000001
10010000000001
10000000000001
10000000000001
10001000001001
1010P000000001
10000000000001
11111111111111
